---------------------------------------------------------------------------------------------------
---------------------------------------------------------------------------------------------------
---------------------------------------------------------------------------------------------------
---------------------------------------------------------------------------------------------------
----------------------------------------------------------|||||||||||||||||||||||------------------
----------------------------------------------------------|.......M.............|------------------
----------------------------------------------------------|.....................|------------------
----------------------------------------------------------|.....................|------------------
----------------------------------------------------------|.....................|------------------
----------------------------------------------------------|.....................|------------------
----------------------------------------------------------|.....................|------------------
----------------------------------------------------------||||||DD|||||||||||||D|------------------
---------------------------------------------------------------|.|------------|.|------------------
---------------------------------------------------------------|.|------------|.|------------------
---------------------------------------------------------------|.|------------|.|------------------
----------------------------||||||||||||||||||||---------------|.|------------|.|------------------
----------------------------|..................|------------||||.||||||||||||||.||||---------------
----------------------------|.......||||||||||.|------------|......................|---------------
----------------------------|.......|--------|.|------------|......................|---------------
----------------------------|.......|--------|.|------------|......................|---------------
----------------------------|.......|------|||D|||||||||||--|......................|---------------
----------------------------|.......|------|.............|--|......................|--|||||||||----
----------------------------|.......|------|.............|--|......................|--|.......|----
----------------------|||||||.......|------|.............|--|........M.............|--|.......|----
----------------------|.....D.......|------|.............|--|.......M..............|--|.......|----
----||||||||----------|.|||||.......|------|.............|--|......................|--|.......|----
----|......|----------|.|---|.......|------|......?......|||||.....................|--|.......|----
----|......|----------|.|---|||||||.|------|.....?.?.....D.........M...............|--|.......|----
----|......|----------|.|---------|.|------|...M?...?....|||||.....................|--|.......|----
----|......|----------|.|---------|.|------|...?.....?...|--|.................M....|--|.......|----
----|......|----------|.|---------|.||||||||..?...1...?..|||||||DD|D|.|.|||||||||||||||.......|----
----|......|----------|.|---------|........D...?.....?...........||...........................|----
----|......|----------|.|---------||||||||||....?...?....||||||||||||||||||||||||||||||.......|----
----||||||||----------|.|------------------|.....?.?.....|----------------------------|D|||D|||----
----------------------|.|------------------|......?......|----------------------------|.|-|.|------
----------------------|.|------------------|.............|----------------------------|.|||.|------
----------------------|.|------------------|.............|----------------------------|.....|------
---------------||||||||.|||||||||||||------|.............|----------------------------|.|||||------
---------------|....................|------|.............|----------------------------|.|----------
---------------|....................|------|.|||||||||||||----------------------------|.|----------
---------------|....................||||||||.|----------------------------------------|.|----------
---------------|....................D........|----------------------------------------|.|----------
---------------|....................|||.||||||----------------------------------------|.|----------
---------------|....................|-|.|------||||||||||||||||||||||||||||||||||||||||.|----------
-----|||||||||-|....................|||.|------|........................................|----------
-----|.......|-|....................D...|------|..............|||.|||||||||||||||||||||||----------
-----|.......|-||.||||||||||||||D|||||||||||||||..............|-|.|--------------------------------
-----|.......||||.|------------|..............................|||.|--------------------------------
-----|.......D....|------------|||||||||||||||||..............D...|--------------------------------
-----|.......||||||----------------------------|..............|||||--------------------------------
-----|.......|---------------------------------|..............|------------------------------------
-----|.......|---------------------------------|..............|------------------------------------
-----|.......|---------------------------------|..............|------------------------------------
-----|||||||||---------------------------------||||||||||||||||------------------------------------
---------------------------------------------------------------------------------------------------
---------------------------------------------------------------------------------------------------
---------------------------------------------------------------------------------------------------
---------------------------------------------------------------------------------------------------
---------------------------------------------------------------------------------------------------
