---------------------------------------------------------------------------------------------------
---------------------------------------------------------------------------------------------------
---------------------------------------------------------------------------------------------------
---------------------------------------------------------------------------------------------------
-----------------------------||||||||||||----------------------------------------------------------
-----------------------------|.......M..|----------------------------------------------------------
-----------------------------|..........|----------------------------------------------------------
-----------------------------|..........|----------------------------------------------------------
-----------------------------|..........|----------------------------------------------------------
-------------------------|||||..........|----------------------------------------------------------
-------------------------|...D..........|----------------------------------------------------------
-------------------------|.||||||D|||||||----------------------------------------------------------
-------------------------|....|-|.|----------------------------------------------------------------
-------------------------|.||.|-|.|----------------------------------------------------------------
-------------------------|.||.|-|.|----------------------------------------------------------------
-------------------------|.||.|-|.|----------------------------------------------------------------
-----------|||||||||||||||.||D|||.||||||||||||||||||||||||-----------------------------------------
-----------|......D......................................|-----------------------------------------
-----------|.|||||||.|...............|||||||||||||||.|||.|-----------------------------------------
-----------|.|----||.|.....M.........|-------------|.|-|.|-----------------------------------------
-----------|.|----||.|...............|-----|||||||||D|||D||||||||||||||||||||||||------------------
-----------|.|----||.|...............|-----|....................................|------------------
-----|||||||.|----||.|...............|-----|.............|.||||||||||||||||||||.|------------------
-----|.......|----||.|...............|-----|.............|.|------------------|.|------------------
-----|.......|----||.|...............|-----|.............|.|------------------|.|------------------
-----|.......|||||||.|...............|-----|...........M.|.|------------------|.|------------------
-----|.......D.....|.|...............|-----|......?......|.|------------------|.|------------------
-----|.......|||||||.|...............|-----|.....?.?.....|.|------------------|D|||||||||||--------
-----|.......|||||||.|||||||||||||||||-----|....?...?....|.|------------------|...........|--------
-----|.............|.|---------------------|...?.....?...D.|------------------|...........|--------
-----|.......|||||.|.|---------------------|..?...1...?..D||------------------|...........|--------
-----|||||D|||---|.|.|---------------------|...?.....?...|--------------------|...........|--------
---------|.|-----|.|.|---------------------|....?...?....|--------------------|...........|--------
---------|.|-----|.|.|---------------------|.....?.?....M|--------------------|.M.........|--------
---------|.|||||||D|.|---------------------|......?......|--------|||||||||||||||||||||||D|--------
---------|.........|.|---------------------|.............|--------|.......................|--------
---------|.||......|.|---------------------|.............|--------|.||||||||.||.|||||||||||--------
---------|.||......D.|---------------------|.............|--------|........|.||.|------------------
---------|.||......|||---------------------|.............|--------|........|.|..|------------------
---------|.||......|||||||||||||||||||||---||||DD|||||||||--------|........|.||.|------------------
---------|.||......D...................|------|.|-----------------|........|.||.|------------------
---------|.||......|||||||||||||||||||.|------|.|-------|||||||||||M.......|.|..|------------------
---------|.||......|-----------------|.|------|.|-------|.........D........|.||||------------------
---------|.||......|-----------------|.|------|.|-------|.|||||||||........D.|---------------------
---------|..D......|-----------------|.||||||||.|||||||||.|-------|........D||---------------------
---------|||D......|-----------------|....................|||||||||||||D||||-----------------------
------------|......|-----------------|..................................|--------------------------
------------|......|-----------------|....................|||||||||||||||--------------------------
------------||||||||-----------------|....................|----------------------------------------
-------------------------------------|....................|----------------------------------------
-------------------------------------|....................|----------------------------------------
-------------------------------------|....................|----------------------------------------
-------------------------------------|....................|----------------------------------------
-------------------------------------||||||||||||||||||||||----------------------------------------
---------------------------------------------------------------------------------------------------
---------------------------------------------------------------------------------------------------
---------------------------------------------------------------------------------------------------
---------------------------------------------------------------------------------------------------
---------------------------------------------------------------------------------------------------
