---------------------------------------------------------------------------------------------------
---------------------------------------------------------------------------------------------------
---------------------------------------------------------------------------------------------------
---------------------------------------------------------------------------------------------------
---------------------------------------------------------------------------------------------------
---------------------------||||||||||||||||||||||--------------------------------------------------
---------------------------|....................|--------------------------------------------------
---------------------------|....................|--------------------------------------------------
---------------------------|....................|--------------------------------------------------
-----------------------|||||....................|||||||||||||||||||||||||||||||--------------------
-----------------------|...D....................D.............................|--------------------
-----------------------|.|||....................|.||||||||.||||||||||||||||||.|--------------------
-----------------------|.||||D||||||||||D|||||DD|.|------|.|------------|||||D|||||----------------
-----------------------|......|--------|.|---|.||.|------|.|------------|.........|----------------
-----------------------|.|.||||--------|.|---|.||.|------|.|------------|......M..||||-------------
----------------------||.|.|||D|||||||||.|---|.||.|------|.|------------|.........D..|-------------
----------------------|..................|---|....|------|.|------------|............|-------------
----------------------|..........|||.|||||---||||.|------|.|------------|.........||.|-------------
----------------------|..........|-|.|----------|.|------|.|------------|.........||.|-------------
-----------------||||||..........|||.|----------|.|------|.|------------|.........||.|-------------
-----------------|....D.........MD...|-----||||||.||||||||.|------------|.........||.|-------------
-----------------|.||||..........|||.|-----|.............|.|------------|||D||.|||||.|-------------
-----------------|.|..D..........|-|.|||||||............M|.|--------------|..........|-------------
-----------------|.|.|||||||||||||-|.......D.............D.|--------------||||||||||.|-------------
-----------------|.|.|-------------|||.||||D.............|||-----------------------|.|-------------
-----------------|.|.|---------------|.|---|.............|-------------------------|.|-------------
-------------|||||.|.|---------------|.|---|......?......|-------------------------|.|-------------
-------------|.....|.||||||----------|.|---|.....?.?.....|-------------------------|.|-------------
-------------|.|||.|......|----------|.|---|....?...?....|-------------------------|.|-------------
-------------|.|-|.|.||||.|----------|.|---|...?.....?...|-------------------------|.|-------------
-------------|.|-|.|.|--|.|----------|.|---|..?...1...?..|-------------------------|.|-------------
-----------|||D|||.|.||||D||---------|.|---|...?.....?...|-------------------------|.|-------------
-----------|...............|---------|.|---|....?...?....|-------------------------|.|-------------
-----------|...............|---------|.|---|.M...?.?.....|-------------------------|.|||||||||-----
-----------|...............|---------|.|---|......?......|-------------------------|.........|-----
-----------|...............|---------|.|||||.............|-------------------------|.........|-----
-----------|...............|---------|.....D.............|-------------------------|.........|-----
-----------|...............|---------|||||||.............|--------------||||||||||||.........|-----
-----------|...............|---------------|.............|--------------|..........D.........|-----
-----------|...............|---------------|||||.|||||||||--------------|.||||.|||||.........|-----
-----------|...............|-------------------|.||||||||||||||||||||||||.|--|.|||||.........|-----
-----------|...............|-------------------|.....D....................|--|.....D.........|-----
-----------|||||||||||||||||-------------------||.||||........M...........|--|.|||||.........|-----
------------------------------------------------|.|--|....................|--|.|---|.........|-----
------------------------------------------------|.||||....................|--|.|---|||||.||..|-----
------------------------------------------------|....D....................|--|.|------||.||..|-----
------------------------------------------------||||||....................|--|.|------|......|-----
-----------------------------------------------------|....................|--|.|------|....M.|-----
-----------------------------------------------------|....................||||.|------|......|-----
-----------------------------------------------------|....................D....|------|......|-----
-----------------------------------------------------|....................||||||------|......|-----
-----------------------------------------------------|....................|-----------|......|-----
-----------------------------------------------------||||||||||||||||||||||-----------||||||||-----
---------------------------------------------------------------------------------------------------
---------------------------------------------------------------------------------------------------
---------------------------------------------------------------------------------------------------
---------------------------------------------------------------------------------------------------
---------------------------------------------------------------------------------------------------
---------------------------------------------------------------------------------------------------
